0,0,0,0,2,2,2,0,0,0
0,1,4,0,2,6,2,0,0,0
1,1,4,4,2,2,2,4,4,4
0,0,0,0,0,0,3,4,4,4
0,0,0,0,0,0,3,0,0,4
0,0,0,0,0,0,3,0,0,4
5,4,4,4,4,4,4,4,4,4
0,0,0,0,0,0,4,0,0,4
0,0,0,0,0,0,4,0,0,4
0,0,0,0,0,0,4,4,4,4